0 0 0 0 0 0 0 0 0 127 127 127 127 127 127 127 127 127 127 0 0 0 0 0 0 0 0 0 0 0 0 0 0 0 0 0 0 0 0 0 0 0 0 0 0 0 0 0 0
0 0 0 0 0 0 0 0 0 127 127 127 127 127 127 127 127 127 127 0 0 0 0 0 0 0 0 0 0 0 0 0 0 0 0 0 0 0 0 0 0 0 0 0 0 0 0 0 0
0 0 0 0 0 0 0 0 0 127 101 101 101 101 101 101 101 101 127 127 127 127 127 127 127 127 127 127 127 127 127 127 127 127 127 127 127 127 127 127 127 127 127 127 127 127 127 127 127
0 0 0 0 0 0 0 0 0 127 121 121 121 121 121 121 121 121 127 127 127 127 127 127 127 127 127 127 127 127 127 127 127 127 127 127 127 127 127 127 127 127 127 127 127 127 127 127 127
0 0 0 0 0 0 0 0 0 127 101 127 127 127 127 127 127 101 127 0 0 0 0 0 51 0 0 0 127 0 0 0 0 0 51 0 0 0 127 0 0 0 0 0 51 0 0 0 127
0 0 0 0 0 0 0 0 0 127 121 127 127 127 127 127 127 121 127 0 0 0 0 0 61 0 0 0 127 0 0 0 0 0 61 0 0 0 127 0 0 0 0 0 61 0 0 0 127
0 0 0 0 0 0 0 0 0 127 101 127 127 127 127 127 127 101 127 0 0 127 127 127 127 127 127 127 127 127 127 127 127 127 127 127 127 127 127 127 127 127 127 127 127 127 127 127 127
0 0 0 0 0 0 0 0 0 127 121 127 127 127 127 127 127 121 127 0 0 127 127 127 127 127 127 127 127 127 127 127 127 127 127 127 127 127 127 127 127 127 127 127 127 127 127 127 127
127 127 127 127 127 127 127 127 127 127 101 101 0 0 0 0 101 101 127 0 0 0 0 0 0 0 0 0 127 0 0 0 0 0 0 0 0 0 127 0 0 0 0 0 0 0 0 0 127
127 127 127 127 127 127 127 127 127 127 121 121 0 0 0 0 121 121 127 0 0 0 0 0 0 0 0 0 127 0 0 0 0 0 0 0 0 0 127 0 0 0 0 0 0 0 0 0 127
127 127 127 0 0 101 101 101 0 0 0 0 0 0 0 0 0 0 127 0 51 51 51 0 51 51 51 0 127 0 51 51 51 0 51 51 51 0 127 0 51 51 51 0 51 51 51 0 127
127 127 127 0 0 121 121 121 0 0 0 0 0 0 0 0 0 0 127 0 61 61 61 0 61 61 61 0 127 0 61 61 61 0 61 61 61 0 127 0 61 61 61 0 61 61 61 0 127
127 0 0 0 101 127 127 127 101 0 0 0 101 101 101 0 0 0 127 0 51 0 51 0 51 0 51 0 127 0 51 0 51 0 51 0 51 0 127 0 51 0 51 0 51 0 51 0 127
127 0 0 0 121 127 127 127 121 0 0 0 121 121 121 0 0 0 127 0 61 0 61 0 61 0 61 0 127 0 61 0 61 0 61 0 61 0 127 0 61 0 61 0 61 0 61 0 127
127 127 127 0 101 127 127 127 101 0 0 101 127 127 127 101 0 0 127 0 51 0 51 0 51 0 51 0 127 0 51 0 51 0 51 0 51 0 127 0 51 0 51 0 51 0 51 0 127
127 127 127 0 121 127 127 127 121 0 0 121 127 127 127 121 0 0 127 0 61 0 61 0 61 0 61 0 127 0 61 0 61 0 61 0 61 0 127 0 61 0 61 0 61 0 61 0 127
127 0 0 0 0 101 101 101 0 0 0 101 127 127 127 101 0 0 127 0 51 0 51 0 51 0 51 0 127 0 51 0 51 0 51 0 51 0 127 0 51 0 51 0 51 0 51 0 127
127 0 0 0 0 121 121 121 0 0 0 121 127 127 127 121 0 0 127 0 61 0 61 0 61 0 61 0 127 0 61 0 61 0 61 0 61 0 127 0 61 0 61 0 61 0 61 0 127
127 127 127 0 0 0 0 0 0 0 0 101 127 127 127 101 0 0 127 0 51 0 51 0 51 0 51 0 127 0 51 0 51 0 51 0 51 0 0 0 51 0 51 0 51 0 51 0 127
127 127 127 0 0 0 0 0 0 0 0 121 127 127 127 121 0 0 127 0 61 0 61 0 61 0 61 0 127 0 61 0 61 0 61 0 61 0 0 0 61 0 61 0 61 0 61 0 127
127 127 127 0 0 101 101 101 0 0 0 101 127 127 127 101 0 0 127 0 51 0 51 0 51 0 51 0 127 0 51 0 51 0 51 0 51 0 127 0 51 0 51 0 51 0 51 0 127
127 127 127 0 0 121 121 121 0 0 0 121 127 127 127 121 0 0 127 0 61 0 61 0 61 0 61 0 127 0 61 0 61 0 61 0 61 0 127 0 61 0 61 0 61 0 61 0 127
127 0 0 0 101 127 127 127 101 0 0 0 101 101 101 0 0 0 127 0 51 0 51 0 51 0 51 0 127 0 51 0 51 0 51 0 51 0 127 0 51 0 51 0 51 0 51 0 127
127 0 0 0 121 127 127 127 121 0 0 0 121 121 121 0 0 0 127 0 61 0 61 0 61 0 61 0 127 0 61 0 61 0 61 0 61 0 127 0 61 0 61 0 61 0 61 0 127
127 127 127 0 101 127 127 127 101 0 0 0 0 0 0 0 0 0 127 0 51 0 51 0 51 0 51 0 127 0 51 0 51 0 51 0 51 0 127 0 51 0 51 0 51 0 51 0 127
127 127 127 0 121 127 127 127 121 0 0 0 0 0 0 0 0 0 127 0 61 0 61 0 61 0 61 0 127 0 61 0 61 0 61 0 61 0 127 0 61 0 61 0 61 0 61 0 127
127 0 0 0 101 127 127 127 101 0 0 0 101 101 101 0 0 0 127 0 51 0 51 0 51 0 51 0 127 0 51 0 51 0 51 0 51 0 127 0 51 0 51 0 51 0 51 0 127
127 0 0 0 121 127 127 127 121 0 0 0 121 121 121 0 0 0 127 0 61 0 61 0 61 0 61 0 127 0 61 0 61 0 61 0 61 0 127 0 61 0 61 0 61 0 61 0 127
127 127 127 0 0 101 101 101 0 0 0 101 127 127 127 101 0 0 127 0 51 0 51 0 51 0 51 0 0 0 51 0 51 0 51 0 51 0 127 0 51 0 51 0 51 0 51 0 127
127 127 127 0 0 121 121 121 0 0 0 121 127 127 127 121 0 0 127 0 61 0 61 0 61 0 61 0 0 0 61 0 61 0 61 0 61 0 127 0 61 0 61 0 61 0 61 0 127
127 127 127 0 0 0 0 0 0 0 0 101 127 127 127 101 0 0 127 0 51 0 51 0 51 0 51 0 127 0 51 0 51 0 51 0 51 0 127 0 51 0 51 0 51 0 51 0 127
127 127 127 0 0 0 0 0 0 0 0 121 127 127 127 121 0 0 127 0 61 0 61 0 61 0 61 0 127 0 61 0 61 0 61 0 61 0 127 0 61 0 61 0 61 0 61 0 127
127 0 0 0 0 101 101 101 0 0 0 101 127 127 127 101 0 0 127 0 51 0 51 0 51 0 51 0 127 0 51 0 51 0 51 0 51 0 127 0 51 0 51 0 51 0 51 0 127
127 0 0 0 0 121 121 121 0 0 0 121 127 127 127 121 0 0 127 0 61 0 61 0 61 0 61 0 127 0 61 0 61 0 61 0 61 0 127 0 61 0 61 0 61 0 61 0 127
127 127 127 0 101 127 127 127 101 0 0 101 127 127 127 101 0 0 127 0 51 0 51 0 51 0 51 0 127 0 51 0 51 0 51 0 51 0 127 0 51 0 51 0 51 0 51 0 127
127 127 127 0 121 127 127 127 121 0 0 121 127 127 127 121 0 0 127 0 61 0 61 0 61 0 61 0 127 0 61 0 61 0 61 0 61 0 127 0 61 0 61 0 61 0 61 0 127
127 0 0 0 101 127 127 127 101 0 0 0 101 101 101 0 0 0 0 0 51 0 51 51 51 0 51 51 127 0 51 0 51 51 51 0 51 51 127 0 51 0 51 51 51 0 51 51 127
127 0 0 0 121 127 127 127 121 0 0 0 121 121 121 0 0 0 0 0 61 0 61 61 61 0 61 61 127 0 61 0 61 61 61 0 61 61 127 0 61 0 61 61 61 0 61 61 127
127 127 127 0 0 101 101 101 0 0 0 0 0 0 0 0 0 0 127 0 0 0 0 0 0 0 0 0 127 0 0 0 0 0 0 0 0 0 127 0 0 0 0 0 0 0 0 0 127
127 127 127 0 0 121 121 121 0 0 0 0 0 0 0 0 0 0 127 0 0 0 0 0 0 0 0 0 127 0 0 0 0 0 0 0 0 0 127 0 0 0 0 0 0 0 0 0 127
127 127 127 127 127 127 127 127 127 127 127 127 127 127 127 127 127 127 127 127 127 127 127 127 127 127 127 127 127 127 127 127 127 127 127 127 127 127 127 127 127 127 127 127 127 127 127 127 127
127 127 127 127 127 127 127 127 127 127 127 127 127 127 127 127 127 127 127 127 127 127 127 127 127 127 127 127 127 127 127 127 127 127 127 127 127 127 127 127 127 127 127 127 127 127 127 127 127
