9 0 4 4 0 2 10 3 2 127 127 127 127 127 127 127 127 127 127 127 127 127 127 127 127 127 127 127 127 5 7 3 10 6 6 0 6 10 2
7 0 10 9 7 10 6 3 0 127 127 127 127 127 127 127 127 127 127 127 127 127 127 127 127 127 127 127 127 12 5 12 0 12 9 8 9 6 12

5 2 3 9 2 10 11 4 10 127 127 64 92 37 44 58 55 95 22 127 127 127 127 127 127 127 127 127 127 127 127 127 127 127 127 127 127 127 127 127 127
0 8 9 3 11 7 3 8 7 127 127 21 97 77 60 92 47 70 50 127 127 127 127 127 127 127 127 127 127 127 127 127 127 127 127 127 127 127 127 127 127

10 3 4 0 6 7 4 7 6 127 127 67 127 127 127 127 127 127 127 127 127 127 127 127 60 127 127 3 6 5 7 4 5 10 4 5 127 127
2 0 2 0 6 9 0 8 1 127 127 83 127 127 127 127 127 127 127 127 127 127 127 127 38 127 127 4 11 6 10 6 36 8 9 5 127 127

6 8 0 6 1 1 4 6 12 127 127 53 127 127 127 127 127 127 127 127 127 127 127 127 47 127 127 5 6 127 127 127 127 127 127 127 127 127 127 127 127 127 127 127 127
9 4 2 6 2 5 6 8 9 127 127 39 127 127 127 127 127 127 127 127 127 127 127 127 49 127 127 8 6 127 127 127 127 127 127 127 127 127 127 127 127 127 127 127 127

127 127 127 127 127 127 127 127 127 127 127 127 127 127 127 127 127 127 127 127 90 54 3 5 7 2 13 48 127 127 0 8 5 4 9 7 1 7 4 127 127
127 127 127 127 127 127 127 127 127 127 127 127 127 127 127 127 127 127 127 127 22 12 11 1 2 1 81 83 127 127 11 4 8 10 5 10 9 10 9 127 127

127 127 127 127 127 127 12 1 65 9 53 9 4 1 1 5 2 8 9 9 2 127 127 5 50 17 11 4 0 36 13 3 127 127
127 127 127 127 127 127 1 7 62 1 65 5 0 4 6 3 8 3 2 0 0 127 127 1 19 48 24 6 59 45 28 9 127 127

127 127 1 7 11 84 127 127 127 127 127 127 57 0 5 6 9 29 95 10 2 12 127 127 10 16 0 2 2 36 2 27 7 127 127
127 127 7 11 6 17 127 127 127 127 127 127 10 5 3 8 47 27 20 5 3 10 127 127 4 55 11 8 1 16 0 7 10 127 127

127 127 127 127 127 127 5 8 127 127 127 127 127 127 13 2 9 70 127 127 127 127 127 127 87 11 2 127 127 3 27 11 47 10 37 12 61 6 127 127
127 127 127 127 127 127 9 61 127 127 127 127 127 127 61 4 2 73 127 127 127 127 127 127 79 5 8 127 127 4 11 8 2 6 43 5 41 7 127 127

127 127 3 3 4 4 85 29 55 7 9 8 19 127 127 127 127 127 127 26 0 12 127 127 11 16 11 47 10 46 1 58 1 127 127
127 127 11 1 12 5 88 45 74 5 7 5 98 127 127 127 127 127 127 20 4 3 127 127 7 49 8 47 3 3 0 59 2 127 127

127 127 127 127 127 127 11 6 2 0 3 5 2 11 89 127 127 127 127 127 127 60 4 9 127 127 12 46 8 31 4 43 11 40 5 127 127
127 127 127 127 127 127 11 9 3 7 0 5 11 1 76 127 127 127 127 127 127 13 1 7 127 127 4 20 11 22 0 15 7 23 0 127 127

127 127 127 127 127 127 7 8 53 26 58 6 3 4 86 127 127 127 127 127 127 60 8 0 127 127 7 24 0 30 6 22 10 62 1 127 127
127 127 127 127 127 127 2 2 52 23 57 10 11 9 5 127 127 127 127 127 127 28 4 8 127 127 8 37 3 8 2 28 7 29 5 127 127

127 127 0 5 7 82 127 127 127 127 127 127 1 0 9 6 39 25 80 4 10 8 127 127 11 31 10 0 1 1 4 26 3 127 127
127 127 5 0 0 58 127 127 127 127 127 127 64 0 11 7 24 70 64 11 6 10 127 127 2 15 1 62 3 37 4 25 1 127 127

127 127 127 127 127 127 11 68 127 127 127 127 127 127 78 0 2 4 11 10 11 0 5 7 127 127 8 11 8 57 3 16 1 46 7 127 127
127 127 127 127 127 127 12 70 127 127 127 127 127 127 56 3 11 5 11 2 10 6 8 6 127 127 1 53 8 24 5 36 6 15 2 127 127

127 127 7 10 8 32 127 127 127 127 127 127 100 8 7 10 88 17 35 3 3 5 127 127 12 37 9 46 9 33 3 42 12 127 127
127 127 5 2 3 74 127 127 127 127 127 127 12 12 8 3 36 45 59 1 1 3 127 127 6 44 5 29 6 32 12 51 7 127 127

127 127 127 127 127 127 11 8 39 86 4 0 0 3 18 127 127 127 127 127 127 50 3 4 127 127 12 10 6 37 6 2 2 59 9 127 127
127 127 127 127 127 127 6 8 50 66 60 11 6 0 4 127 127 127 127 127 127 61 2 10 127 127 5 38 5 38 7 5 11 21 7 127 127

127 127 127 127 127 127 3 7 8 4 2 4 4 7 28 127 127 127 127 127 127 45 0 3 127 127 6 37 4 39 3 8 10 1 8 127 127
127 127 127 127 127 127 3 5 11 3 2 3 0 0 78 127 127 127 127 127 127 37 6 6 127 127 7 17 9 23 8 15 0 26 9 127 127

127 127 8 9 11 11 9 43 66 0 12 2 59 127 127 127 127 127 127 11 2 2 127 127 1 17 5 10 6 24 1 13 5 127 127
127 127 0 9 8 5 90 2 91 6 2 7 52 127 127 127 127 127 127 35 2 2 127 127 0 27 9 30 11 61 6 6 9 127 127

127 127 127 127 127 127 2 98 127 127 127 127 127 127 63 10 3 30 127 127 127 127 127 127 68 11 5 127 127 5 0 3 48 1 28 1 10 6 127 127
127 127 127 127 127 127 10 98 127 127 127 127 127 127 74 10 8 9 127 127 127 127 127 127 69 6 7 127 127 0 9 5 5 8 50 9 60 10 127 127

127 127 8 1 1 98 127 127 127 127 127 127 20 9 4 4 39 14 92 11 2 6 5 2 33 3 49 39 29 3 2 8 127 127
127 127 9 10 6 92 127 127 127 127 127 127 69 1 12 11 17 27 69 6 4 4 6 9 16 10 4 11 32 4 2 13 127 127

127 127 127 127 127 127 8 0 41 81 29 10 8 5 7 5 6 1 0 1 2 127 127 5 5 8 2 0 11 5 5 11 127 127
127 127 127 127 127 127 2 9 86 82 69 12 4 10 7 5 0 2 1 8 11 127 127 11 10 11 5 10 2 3 2 2 127 127

127 127 127 127 127 127 127 127 127 127 127 127 127 127 127 127 127 127 127 127 127 127 127 127 127 127 127 127 127 127 127 127 127 127 127 127 127 127 127 127 127 127 127 127 127 127 127 127 127 127 127 127 127 127 127 127
127 127 127 127 127 127 127 127 127 127 127 127 127 127 127 127 127 127 127 127 127 127 127 127 127 127 127 127 127 127 127 127 127 127 127 127 127 127 127 127 127 127 127 127 127 127 127 127 127 127 127 127 127 127 127 127

